+-+-+-+-+
        |
+-+-+ +-+
|     | |
+-+ +-+ +
|   | | |
+ +-+ + +
|        
+-+-+-+-+